1111111111111111111111111111111111
1111111000000000000100000000000001
1000000C00000000000100000000001111
10000001000000P0000100000000000001
1001001001000000000100000000001001
100100100100000000010000C000000001
1001001001000000000100000000100001
10010010010000000000000000E0000101
1111111111111111111111111111111111